 ###########################
 # . ### . ! . . . . . . . #
 # . # # . ### . ### ? # . #
 # . ### . ### . ### . / . #
 # . . . . /// . ####### . #
## . ######### . . . .######
#0 . ## . . .  . ####### . #
## . ## . ####### . . ## . #
 # . ## ? . . . . . #### . >>>
 # . ###########//###### ! #
 # . . . #### . . . . // . #
 ###########################
