######################
#0 . //. . . . .## . >>>
## . ######### .## . #
 # . ##. . . . .## . #
 # ! ##. ### .#### . #
 # . ##. # # . ### . #
 # . . . # # . ?## . #
 ##### . ### . ### . #
 # . ! . //. . . . . #
 #####################
