##############################################
## . // . . . . .## .  . ! ##. ! .// . . #####
## . ## . ####. .## . ## . ########### . . ?>>>
## . ## . ####. .## . ## . ## .  . .## . #####
## . ## . ##! . .## . ## . ## . ## . . .  . ##
## . ## . ##. .#### . ## . ## . ##########. ##
## ! ## . ##. . .## . ## . ## . . . ? . ##. ##
## . ## . ####. .## . ## . ## . ##########. ##
## . ## . ##. ? .## . ## .  . . ## . . .  . ##
## . ## . ##. .#### . ############ .## . #####
## . ## . ##. . . . . ##.  . . ##. .## .  . ##
## . ## . ####//########. ## . ##. .##### . ##
## . ## ! . . . . . . . . ## . ##. . . ## ! ##
## . #########. ############ . ######. ## . ##
## .  . . . ##. ## . . . . //. . ? ##. ## . ##
######### . ##. ## . ### . ######. ##. ## . ##
##. . . . . ##. ## . ### . . . . . ##. ## . ##
##. ### . ####. // . ################. ## . ##
##? /// . . . . ## .  . . . . .  ##. ? ## . ##
########################### 0 ################
                          #####
