#################################################
## . . . . . . . . . . ? . . . . . . . . . . . ##
## . ############################# . ####### . ##
## ! ## . . . . . . . . . . . . ## . ## . ## . ##
## . ## . ################### . ## . ## . ## . ##
## . ## . ## . . . . . . . ## . ## . ## . ## . ##
## . ## . ## . ############## . ## . ## . ## . ##
## . ## . ## . ## . . . . . . . ## . ## ? ## . ##
## . ## . ## . // . ######### . ## . ## . ## . ##
## . ## . ## . ## . ##     ## . ## . ## . ## . ##
## . ## . ## . ## . ##     ## . ## . ## . ## . ##
## . ## . ## . ## . ##     ## . ## . ## . ## . ##
## . ## ? ## . ## . ######### . ## . ## . ## . ##
## . ## . ## . ## . . ! . . . . ## . ## . ## . ##
## . ## . ## . ## . ######### . ## ? ## . ## . ##
## . ## . ## . ## . ##  0 . . . ## . ## . ## . ##
## . .  . ## ! ## . ############## . ## . ## . ##
## . ## . ## . ## . ## . . . . . . . .  . // . ##
## . ## . ## . ########//############## ! ## . ##
## ? ## . ## . . . . . . . . ! . . . ## ! ## ? ##
####################################### ! #######
                                        >>>
